R 480 352 
C 123,222,343
F 334,455,232
NO ./path_to_the_north_texture
SO ./path_to_the_south_texture
WE ./path_to_the_west_texture
EA ./path_to_the_east_texture
S ./path_to_the_sprite_texture

111111111111111
100000011000001
100000000001111
100000000000001
100110000000001
100000000N00001
100001100000001
100000000000001
101100000000001
100000000000001
111111111111111
